Aedoc	エドック
Agnes	アグネス
Arnold	アーノルド
Amalie	アマリー
Big Jorg	ビッグ・ヨルグ
Brigita	ブリギータ
Cecilia	セシリア
Claus	クラウス
Else	エルゼ
Endris	エンドリス
Ferenc	フェレンツ
Florian	フロリアン
Frantz	フランツ
Gernot	ゲルノット
Gertrude	ゲルトルート
Grett	グレット
Guy	ガイ
Piero	ピエロ
Thomas	トマス
Johan	ヨハン
Lijsbet	ライズベット
Lukas	ルーカス
Margarete	マルガレーテ
Marie	マリー
Martin	マルティン
Mathieu	マチュー
Matilda	マチルダ
Michlaus	ミヒラウス
Old Otto	オールド・オットー
Otto	オットー
Peter	ペテロ
Rutegar	ルテガル
Salomea	サロメア
Sebhat	セバト
Smokey	スモーキー
Ulrich	ウルリッヒ
Volkbert	ヴォルクベルト
Widow	ウィドウ
Wojslav	ヴォイスラフ
Lenhardt	レンハルト
Lorenz	ロレンツ
Illuminata	イルミナータ
Jacob	ヤコブ
Werner	ヴェルナー
Veronica	ヴェロニカ
Clara	クララ
Eva	エヴァ
Heddy	ヘディ
Kat	キャット
Lucky	ラッキー
Albertus Magnus	アルベルトゥス・マグヌス
Alexander	アレキサンダー
Anna	アンナ
Anton	アントン
Apollo	アポロ
Artemis	アルテミス
Baltasar	バルタザール
Benedicta	ベネディクタ
Benjamin	ベンジャミン
Bertholdt	ベルトルト
Black Til	ブラック・ティル
Brigita	ブリギータ
Caspar	キャスパー
Cecilia	セシリア
Christina	クリスティーナ
Clara	クララ
Esther	エステル
Eva	エヴァ
Fabian	ファビアン
Franziska	フランツィスカ
Gnaziu	グナジウ
Hanna	ハンナ
Hans	ハンス
Heddy	ヘディ
Ill Peter	イル・ペテロ
Illuminata	イルミナータ
Jacob	ヤコブ
Sepp	セップ
Jutta	ユッタ
Karl	カール
Kat	キャット
Kazimierz	カジミエシュ
Kilian	キリアン
Krafft	クラフト
Lady Solomea	サロメア婦人
Lenhardt	レンハルト
Lorenz	ロレンツ
Lucky	ラッキー
Lukas	ルーカス
Magdalene	マグダレネ
Margarete	マルガレーテ
Marie	マリー
Martha	マーサ
Martin	マルティン
Mathieu	マチュー
Matilda	マチルダ
Michlaus	ミヒラウス
Nikolas	ニコラス
Old Otto	オールド・オットー
Otto	オットー
Ötz	オッツ
Paul	パウロ
Peter	ペテロ
Piero	ピエロ
Rachel	レイチェル
Richart	リヒャルト
Rüdeger	リューデガー
Samuel	サミュエル
Sebhat	セバト
Simon	シモン
Smokey	スモーキー
Sophie	ソフィー
Thomas	トマス
Til	ティル
Ulrich	ウルリッヒ
Ulrike	ウルリケ
Ursula	ウルスラ
Vácslav	ヴァーツラフ
Veronica	ヴェロニカ
Volkbert	ヴォルクベルト
Walpurga	ワルプルガ
Werner	ヴェルナー
Widow	ウィドウ
Ottilia	オッティリア
Wojslav	ヴォイスラフ
Wolff	ヴォルフ
Ysabeau	イサボー
Zdena	ズデーニャ
Circator	巡回人
Compline	終課
Corpus Delicti	コーパスデリクティ
Es stultior merda	エス・スタルティオル・メルダ
in flagrante delicto	イン・フラグランテ・デリクト
Lauds	早課
lex talionis	目には目を
solus Christus	ソルス・クリストス
Vespers	晩課
Agricola	アグリコラ
Albertus Magnus	アルベルトゥス・マグヌス
Andromache	アンドロマケー
Benivieni	ベニヴィエニ
Aristotle	アリストテレス
Augustine	アウグスティヌス
Christine de Pizan	クリスティーヌ・ド・ピザン
Cicero	キケロ
Diana	ディアナ
Dioscorides	ディオスコリデス
Duke of Bavaria	バイエルン公爵
Dürer	デューラー
Erasmus	エラスムス
Euclid	ユークリッド
Father Matthias	マティアス神父
Ficino	フィチーノ
Fuggers	フッガー家
Gauls	ガリア人
Guild of Saint Luke	聖ルカ組合
Habsburgs	ハプスブルク家
HaShem	ハーシェム
Hildegard	ヒルデガルト
Huguenots	ユグノー
Jacobus de Voragine	ヤコブス・デ・ウォラギネ
John the Baptist	洗礼者ヨハネ
Juan GarcÍa de Basurto	フアン・ガルシア・デ・バスルト
Julius Caesar	ユリウス・カエサル
Lucretius	ルクレティウス
Lutherans	ルター派
Mars	マルス
Martin Luther	マルティン・ルター
Nero	ネロ
Niccolò Leoniceno	ニッコロ・レオニチェーノ
Origen	オリゲネス
Perchta	ペルヒタ
Perchten	ペルヒテン
Peter Abelard	ペテロ・アベラール
Philip Melanchthon	フィリップ・メランヒトン
Pliny the Elder	ガイウス・プリニウス・セクンドゥス
Prince-Bishop of Freising	フライジング司教
Raetians	ラエティア人
Rannig	ラニッヒ
Richard de Bury	リチャード・ド・ブリー
Saint Christopher	聖クリストファー
Saint Eligius	聖エリギウス
Saint Elizabeth	聖エリザベト
Saint Erasmus	聖エラスムス
Saint George	聖ゲオルギウス
Saint Hubert	聖フーベルト
Saint Luke	聖ルカ
Saint Maurice	聖モーリス
Saint Mauritius	聖モーリシャス
Saint Mortiz	サンモリッツ
Saint Nicholas of Myra	ミラの聖ニコラス
Saint Peter	聖ペテロ
Saint Roch	聖ロクス
Saint Satia	聖サティア
Saul	サウル
Swabian League	シュヴァーベン同盟
Tassia	タシア
Thomas Aquinas	トマス・アクィナス
Thrasymachus	トラシュマコス
William of Ockham	オッカムのウィリアム
Aachen	アーヘン
abattoir	屠殺場
Bavaria	バイエルン
Bologna	ボローニャ
Burgundy	ブルゴーニュ
Cologne	ケルン
Erfurt	エアフルト
Fulda	フルダ
Holy Roman Empire	神聖ローマ帝国
Innsbruck	インスブルック
London	ロンドン
Lugano	ルガーノ
Mainz	マインツ
Nuremberg	ニュルンベルク
Prague	プラハ
Rome	ローマ
Salzburg	ザルツブルク
Santa Margherita	サンタ・マルゲリータ
Seine	セーヌ川
Sion	シオン
Sorbonne	ソルボンヌ
Swabian League	シュヴァーベン同盟
synagogue	シナゴーグ
Tyrol	チロル
Valais	ヴァレー州
Venice	ヴェネツィア
Westphalia	ヴェストファーレン
Worms	ヴォルムス
Zaragoza	サラゴサ
Aeneid	アエネイス
Benedictine	ベネディクト修道院
bergfried	ベルクフリート
blood justice	血の正義
book of hours	時祷書
calefactory	暖房室
cantor	聖歌隊長
cellarer	飲食物管理者
ciborium	チボリウム
Consitutio Criminalis Bambergensis	バンベルク刑事裁判令
Corpus Hermeticum	ヘルメス文書
Council of Constance	コンスタンツ公会議
Cronica Clara	世界年代記
Dance of Death	死の舞踏
De bello Gallico	ガリア戦記
De herbis Cambriae	デ・ヘルビス・カンブリエ
De materia medica	薬物誌
diet	帝国議会
Divine Office	聖務日課
divine reading	レクチオ・ディヴィナ
Edict of Expulsion	アルハンブラ勅令
Eucharist	聖餐
galls	胆汁
Gulden	金貨
Hildegards Phyisca	ヒルデガルドの自然学
Historia de labyrintho librorum	ヒストリア・デ・ラビリント・リブローロム
Historia Tassiae	ヒストリア・タシエ
Holy Lance	聖槍
Imperial Road	帝国の道
In der Maur	インデルマウル
infirmarian	看護人
kitchener	料理人
Landhaus	民宿
Landsknecht	ランツクネヒト
Marienschrein	聖母マリアの聖遺物箱
Natural Law	自然法
ninety-five theses	95 か条の論題
Parzival	パルジファル
Perchtenlauf	ペルヒテンラウフ
Rathaus	ラートハウス
Reichspost	帝国郵便
Romansh	ロマンシュ語
sacristan	聖具保管担当者
Saint Johns Eve	聖ヨハネの前夜祭
scriptorium	写字室
sententia	格言
tabernacle	聖櫃
The Rule	聖ベネディクトの規則
Till Eulenspiegel	ティル・オイレンシュピーゲル
trivium and quadrivium	トリウィウムとクアドリウィウム
vehmic court	フェーメ裁判所
votive candle	献灯ロウソク
Wanderjahre	ワンダーヤーレ
Wild Hunt	ワイルドハント
Wretched Guerrin	惨めなゲリン
Yuletide	ユール
Player	プレイヤー
Rüdeger	リューデガー
Aedoc	エドック
Caspar	キャスパー
Mewmew	ミュウミュウ
Cecilia	セシリア
Ferenc	フェレンツ
Florian	フロリアン
Gernot	ゲルノット
Gertrude	ゲルトルート
Illuminata	イルミナータ
Jacob	ヤコブ
Lorenz	ロレンツ
Magdalene	マグダレネ
Mathieu	マチュー
Matilda	マチルダ
Otto	オットー
Piero	ピエロ
Samuel	サミュエル
Sebhat	セバト
Sophie	ソフィー
Volkbert	ヴォルクベルト
Wojslav	ヴォイスラフ
Margarete	マルガレーテ
Andreas	アンドレアス
Prester John	プレスター・ジョン
Saint Grobian	聖グロビアン
Beatrice	ベアトリーチェ
Socrates	ソクラテス
Lucia	ルシア
Martin	マルティン
Wolff	ヴォルフ
Richart	リヒャルト
Lady Salomea	サロメア婦人
Arnold	アーノルド
Werner	ヴェルナー
Animal	動物
Jacob	ヤコブ
Hanna	ハンナ
Benjamin	ベンジャミン
Rachel	レイチェル
Melencolia	メレンコリア
Baltasar	バルタザール
Niko	ニコ
Kilian	キリアン
Karl	カール
Jobst	ヨブスト
Anton	アントン
Til	ティル
Fabian	ファビアン
Sepp	セップ
Esther	エステル
Tristan	トリスタン
Sepp	セップ
Angelo	アンジェロ
Vincenzo	ヴィンチェンツォ
Marcantonio	マルカントニオ
Barbara	バーバラ
Leuthold	ロイトハルト
Josua	ヨシュア
Philip	フィリップ
Alexander	アレキサンダー
Benedicta	ベネディクタ
Apollo	アポロ
Artemis	アルテミス
Krafft	クラフト
Black Til	ブラック・ティル
Christina	クリスティーナ
Simon	シモン
Jutta	ユッタ
Walpurga	ワルプルガ
Ulrike	ウルリケ
Resi	レジ
Gnaziu	グナジウ
Kazimierz	カジミエシュ
Gargantua	ガルガンチュア
Franziska	フランツィスカ
Susanne	スザンヌ
Ysabeau	イサボー
Martha	マーサ
Elias	エリアス
Josef	ヨーゼフ
Daniel	ダニエル
Sabine	ザビーネ
August	アウグスト
System	システム
Reichspostman	ライヒスポストマン
Haller	ハラー
Helena	ヘレナ
Cemetery	墓地
Exterior	外観
Cellar	地下室
Abattoir	屠殺場
Upper Abbey	大修道院上部
Abbot House	大修道院長の家
Animal Pens	動物の囲い
Chapter House	参事会会議場
Church	教会
Cloister	回廊
Convent Garden	女修道院の庭園
Convent Loquarium	女修道院のロクアリウム
Crypt	地下聖堂
Dormitory	寮
Old Bailey	中央刑事裁判所
Guest House	ゲストハウス
Courtyard & Lavatorium	中庭の洗い場
Infirmary	看護室
Kitchen & Cellar	厨房と地下室
Large Garden	広い庭
Library	図書館
Monastery Loquarium	修道院のロクアリウム
Refectory	食堂
Sacristy	聖具室
Scriptorium	写字室
Shrine	聖堂
Tower	塔
Go to Bed	睡眠をとる
Kiersau Abbey	キアサウ修道院
Waterfall	滝
Alban Bakery	アルバンのパン屋
Roman Ruins	ローマ時代の遺跡
Schmidt Smithy	シュミット鍛冶屋
Bridge	橋
Smokeys Home	スモーキーの家
Church & Druckers	教会とドラッカー家
Town Commons	共有地
Frantz Bauer & Widow Kemperyn	フランツ・バウアーとウィドウ・ケンパリン
Gertner Farm	ゲルトナーの農場
Johan Bauer Farm	ヨハン・バウアーの農場
Shrine of St. Satia	聖サティアの聖堂
Meadow	牧草地
Steinauer House	シュタイナウアーの家
Mill	製粉所
Old Salt Mine	古い塩鉱山
Widow Kemperyn/Baltas	ウィドウ・ケンパリン 、バルタス
Zimmermann House	ツィンマーマンの家
Gertner House	ゲルトナーの家
Gertner Guest Room	ゲルトナーの客室
Drucker House	ドラッカーの家
Ottilias Home	オッティリアの家
Johan Bauer House	ヨハン・バウアー の家
Lower Abbey	大修道院下部
Forest	森
Priors House	小修道院長の家
Prioress House	小修道院長の家
Central Town	町中心部
Convent Side	修道院の傍
Golden Hand Inn	宿屋 黄金の手
Golden Hand Guest Room	黄金の手の客室
Guest House Bedroom	ゲストハウスの寝室
Alpine Mountains	アルプスの山岳
Our Lady of the Labyrinth	迷宮の聖母
Lower Aqueduct	水道橋下部
Upper Aqueduct Convent	水道橋上部の修道院
Upper Aqueduct Crypt	水道橋上部の地下聖堂
Nymphaeum	ニンファエウム
North Town	町北部
Cistern	貯水槽
Müller House	ミュラーの家
Isenkopf House	イーズンコフの家
Stolz House	シュトルツの家
Rathaus	ラートハウス
Drucker House Upper	ドラッカーの家上部
Cave	洞窟
Mine Shaft	坑道
Convent Cloister	修道院の回廊
Convent Courtyard	修道院の中庭
Convent Kitchen	修道院の台所
Convent Art Studio	修道院の美術室
Convent Chapel	修道院の礼拝堂
Convent Chapter House	修道院の参事会会議場
Mithraeum	ミトラス神殿
Bathhouse	浴場
Aqueduct	水道橋
Hypocaust	床下暖房
Rathskeller	地下食堂
Windmill Platform	風車の台
Gertner Bedroom	ゲルトナーの寝室
Brigita Baueryn and Wojslav Růžička	ブリギータ・バウエリンとヴォイスラフ・ルージチュカ
Martin Bauer Farm	マルティン・バウアーの農場
Martin Bauer and Widow Kemperyn	マルティン・バウアーとウィドウ・ケンパリン
Kreutzer House	クロイツェルの家
Hans Bauer Farm	ハンス・バウアーの農場
Hans Bauer House	ハンス・バウアーの家
Frantz Bauer House	フランツ・バウアーの家
Martin Bauer House	マルティン・バウアーの家
Brigita Baueryn House	ブリギータ・バウエリンの家
Outer Farms	郊外の農場
Růžička House	ルージチュカの家
Martin Bauer and Wojslav Růžička	マルティン・バウアーとヴォイスラフ・ルージチュカ
Lavatorium	洗い場
Damaged Monstrance	破損した聖体顕示台